1 1 1 1 1 1 1 1 1 1 1 1 1 1 1 1
1 2 2 0 3 5 3 0 3 0 5 0 3 2 2 1
1 2 2 3 0 3 0 3 0 3 0 3 0 2 2 1
1 0 3 0 3 0 3 0 3 0 3 0 3 0 3 1
1 3 0 3 4 3 0 3 0 3 0 4 0 3 0 1
1 0 3 0 3 0 3 0 3 0 3 0 3 0 3 1
1 3 0 3 0 3 0 3 0 3 0 3 0 3 0 1
1 0 3 0 4 0 3 0 3 0 3 4 3 0 3 1
1 3 0 3 0 3 0 3 0 3 0 3 0 3 0 1
1 2 2 0 3 0 3 0 3 0 3 0 3 2 2 1
1 2 2 3 0 5 0 3 0 3 5 3 0 2 2 1
1 1 1 1 1 1 1 1 1 1 1 1 1 1 1 1
